Today is the day! More than a decade of work has led you to this one moment. You nervously walk down a paved stone hallway towards your test. You are incredibly unprepared for this Piano Audition. You haven't practiced or even really decided on what piece you are going to play. In truth you grew so nervous every time you thought of the audition that in the last few weeks leading up to now you had trained yourself not to think of it at all. You woke up today at 9:00 glad that it's finally the weekend and you can for go responsibilities for the next couple days only to find to your shock and dismay that on you calendar was written Piano Audition: 10:00 A.M. You didn't have time to grab sheet music or anything else. You pass through from the west side of the hallway to the east stopping before the attendant's desk.

Prepare for Audition
An Interactive Fiction by Jonathan Nakagawa
Release 1 / Serial number 141007 / Inform 7 build 6L38 (I6/v6.33 lib 6/12N) SD

West Corridor
Beside you here the hum of a black vending machine. Behind you the hallway carries on the east. To the south is a bathroom. In front of you is a small reception desk with a clipboard resting on it and the attendant sitting behind it looking up at you expectantly.

Hello, you must be here for your piano audition. The reviewers are ready for you in the audition room the north. Lets get this over with quickly I really am starving.

>x clipboard
"Instrument Storage Sheet"

 Jonathan Nakagawa , 10, Cello (Programer)

 Andrew Winnicki   , 10, Violin (Beta Tester)

 Emily Lung, 11, Cello (Beta Tester)

 Erik Liu, 10, Piano (Beta Tester)

* * *

>buy oreos
A package of oreos pops out of the machine with a satisfying cha-ching.

>give oreos
(to Attendant)
"Thank you so much! I'm sure the reviewers can wait a while. Here is the key to where we keep all our sheet music. Good luck"

>e
East Corridor
You can hear your own foot falls as you walk down a stone walk way. An older man sits hunched over on a cushioned bench cleaning his finger nails. To the north is the Music Library where all sorts of sheet music is kept. To your east is a Practice Room. Both rooms are locked because its after hours.

>n
(first unlocking the Music Library Door with The Library Key, then opening the door 

Music Library
Rows and rows of sheet music fill this room lining the walls and stretching from floor to celling. However, only shelf holds piano music.

You can see Shelf here.

>take twinkle twinkle
You are not sure what possessed you to take this piece over all the other great works surrounding you but you might as well make the best of it.

>s
East Corridor
You can hear your own foot falls as you walk down a stone walk way. An older man sits hunched over on a cushioned bench cleaning his finger nails. To the north is the Music Library where all sorts of sheet music is kept. To your east is a Practice Room. Both rooms are locked because its after hours.

>talk to older man
What's that you have there. Twinkle Twinkle! Finally someone who understands that the greatest beauty comes from simplicity. Here's the key to the practice room. I'll meet you inside.

>s
(first unlocking the Practice Room Door with The Music Room Key, then opening the door 

Practice Room
As you enter the Practice room only two pieces of furniture stand out to you. One is a black piano with a seat before it on one wall of the room and the other a small dresser. The hallway is back to the west.

>x piano
(Practice Piano)
A stand up piano has been placed in front of a small window. The piano is bare save for a golden inscription. A piano seat stands before the piano.

>sit on seat
You get into Piano Seat.

* * *

>buy oreos
A package of oreos pops out of the machine with a satisfying cha-ching.

>e
East Corridor
You can hear your own foot falls as you walk down a stone walk way. An older man sits hunched over on a cushioned bench cleaning his finger nails. To the north is the Music Library where all sorts of sheet music is kept. To your east is a Practice Room. Both rooms are locked because its after hours.

>w
West Corridor
Beside you here the hum of a black vending machine. Behind you the hallway carries on the east. To the south is a bathroom. In front of you is a small reception desk with a clipboard resting on it and the attendant sitting behind it looking up at you expectantly.

Hello, you must be here for your piano audition. The reviewers are ready for you in the audition room the north. Lets get this over with quickly I really am starving.

>give oreos
(to Attendant)
"Thank you so much! I'm sure the reviewers can wait a while. Here is the key to where we keep all our sheet music. Good luck"

* * *

>n
(first unlocking the Music Library Door with The Library Key, then opening the door 

Music Library
Rows and rows of sheet music fill this room lining the walls and stretching from floor to celling. However, only shelf holds piano music.

You can see Shelf here.

>take twinkle
You are not sure what possessed you to take this piece over all the other great works surrounding you but you might as well make the best of it.

>s
East Corridor
You can hear your own foot falls as you walk down a stone walk way. An older man sits hunched over on a cushioned bench cleaning his finger nails. To the north is the Music Library where all sorts of sheet music is kept. To your east is a Practice Room. Both rooms are locked because its after hours.

>s
(first opening Practice Room Door)
It seems to be locked.

>talk to man
What's that you have there. Twinkle Twinkle! Finally someone who understands that the greatest beauty comes from simplicity. Here's the key to the practice room. I'll meet you inside.

>s
(first unlocking the Practice Room Door with The Music Room Key, then opening the door 

Practice Room
As you enter the Practice room only two pieces of furniture stand out to you. One is a black piano with a seat before it on one wall of the room and the other a small dresser. The hallway is back to the west.

>sit on seat
You get into Piano Seat.

You begin to practice working on all the most difficult sections of the piece. As you work away for more than half an hour you become noticeably better at the piece. You stand up turning to thank the man for his help only to find he is gone.

Practice Room
As you enter the Practice room only two pieces of furniture stand out to you. One is a black piano with a seat before it on one wall of the room and the other a small dresser. The hallway is back to the west.

>sit on seat
You get into Piano Seat.

>exit
You get out of Piano Seat.

Practice Room
As you enter the Practice room only two pieces of furniture stand out to you. One is a black piano with a seat before it on one wall of the room and the other a small dresser. The hallway is back to the west.

>n
East Corridor
You can hear your own foot falls as you walk down a stone walk way. An older man sits hunched over on a cushioned bench cleaning his finger nails. To the north is the Music Library where all sorts of sheet music is kept. To your east is a Practice Room. Both rooms are locked because its after hours.

>n
Music Library
Rows and rows of sheet music fill this room lining the walls and stretching from floor to celling. However, only shelf holds piano music.

You can see Shelf (empty) here.

>l
Music Library
Rows and rows of sheet music fill this room lining the walls and stretching from floor to celling. However, only shelf holds piano music.

You can see Shelf (empty) here.

* * *

>l
Music Library
Rows and rows of sheet music fill this room lining the walls and stretching from floor to celling. However, only shelf holds piano music.

You can see Shelf (empty) here.

I beg your pardon?

>s
East Corridor
You can hear your own foot falls as you walk down a stone walk way. An older man sits hunched over on a cushioned bench cleaning his finger nails. To the north is the Music Library where all sorts of sheet music is kept. To your east is a Practice Room. Both rooms are locked because its after hours.

>s
Practice Room
As you enter the Practice room only two pieces of furniture stand out to you. One is a black piano with a seat before it on one wall of the room and the other a small dresser. The hallway is back to the west.

>n
East Corridor
You can hear your own foot falls as you walk down a stone walk way. An older man sits hunched over on a cushioned bench cleaning his finger nails. To the north is the Music Library where all sorts of sheet music is kept. To your east is a Practice Room. Both rooms are locked because its after hours.

>e
You can't go that way.

>w
West Corridor
Beside you here the hum of a black vending machine. Behind you the hallway carries on the east. To the south is a bathroom. In front of you is a small reception desk with a clipboard resting on it and the attendant sitting behind it looking up at you expectantly.

Hello, you must be here for your piano audition. The reviewers are ready for you in the audition room the north. Lets get this over with quickly I really am starving.

>buy apple
You can't see any such thing.

>buy apples
An apple pops out of the machine with a satisfying cha-ching.

>eat apples
[Your score has just gone up by one point.]

>n
Audition Room
You glance around the room seeing a woman sitting in the audiance section facing a stage. On the stage is a Grand Piano with a Paino Stool resting before it.

A beautiful sleek grand piano is centered in middle of the stage facing towards the audience section.

>talk to woman
You can't see any such thing.

>talk to susan wong
"We are ready when you are."

>give flyer to susan wong
You can't see any such thing.

>s
West Corridor
Beside you here the hum of a black vending machine. Behind you the hallway carries on the east. To the south is a bathroom. In front of you is a small reception desk with a clipboard resting on it and the attendant sitting behind it looking up at you expectantly.

Hello, you must be here for your piano audition. The reviewers are ready for you in the audition room the north. Lets get this over with quickly I really am starving.

>e
East Corridor
You can hear your own foot falls as you walk down a stone walk way. An older man sits hunched over on a cushioned bench cleaning his finger nails. To the north is the Music Library where all sorts of sheet music is kept. To your east is a Practice Room. Both rooms are locked because its after hours.

>s
Practice Room
As you enter the Practice room only two pieces of furniture stand out to you. One is a black piano with a seat before it on one wall of the room and the other a small dresser. The hallway is back to the west.

>take flyer
Taken.

>n
East Corridor
You can hear your own foot falls as you walk down a stone walk way. An older man sits hunched over on a cushioned bench cleaning his finger nails. To the north is the Music Library where all sorts of sheet music is kept. To your east is a Practice Room. Both rooms are locked because its after hours.

>w
West Corridor
Beside you here the hum of a black vending machine. Behind you the hallway carries on the east. To the south is a bathroom. In front of you is a small reception desk with a clipboard resting on it and the attendant sitting behind it looking up at you expectantly.

Hello, you must be here for your piano audition. The reviewers are ready for you in the audition room the north. Lets get this over with quickly I really am starving.

>w
You can't go that way.

>n
Audition Room
You glance around the room seeing a woman sitting in the audiance section facing a stage. On the stage is a Grand Piano with a Paino Stool resting before it.

A beautiful sleek grand piano is centered in middle of the stage facing towards the audience section.

>talk to susan
"Wait, aren't you a Pianist?" you ask. "Yes, in fact I am. How did you know?" "I found this old flyer for one of your recitals." "Oh yes I remember this one. I think I will enjoy your playing very much."

[Your score has just gone up by two points.]

I beg your pardon?

>sit on seat
You can't see any such thing.

>sit on stool
You get into Piano Stool.

    *** As you play through your piece you begin to glare. Every thing sounds slightly off. A few sections sound pretty terrible but some places sound nice. Every note is just off timed, all the dynamics are relatively closely adhered to. You glance over at Susan Wong and find her cleanning her finger nails. When you finish she says, "I won't lie that didn't sound like someone who was prepared. It could have been a lot worse but it could also have been a lot better." You have failed your audition ***

In that game you scored 3 out of a possible 11, in 40 turns.

Would you like to RESTART, RESTORE a saved game, QUIT or UNDO the last command?

* * *

>buy oreos
A package of oreos pops out of the machine with a satisfying cha-ching.

>give ores
You can't see any such thing.

>give oreos
(to Attendant)
"Thank you so much! I'm sure the reviewers can wait a while. Here is the key to where we keep all our sheet music. Good luck"

* * *

>e
East Corridor
You can hear your own foot falls as you walk down a stone walk way. An older man sits hunched over on a cushioned bench cleaning his finger nails. To the north is the Music Library where all sorts of sheet music is kept. To your east is a Practice Room. Both rooms are locked because its after hours.

>n
(first unlocking the Music Library Door with The Library Key, then opening the door 

Music Library
Rows and rows of sheet music fill this room lining the walls and stretching from floor to celling. However, only shelf holds piano music. A plaque is afixed next to the door frame you just entered through.

You can see Shelf here.

>take twinkle
You are not sure what possessed you to take this piece over all the other great works surrounding you but you might as well make the best of it.

* * *

>x
What do you want to examine?

>x piano
You can't see any such thing.

>x black vending machine
A large oblong metal box is pressed up against the wall humming softly. It is filled with various food products.

>x clipboard
"Instrument Storage Sheet"

 Jonathan Nakagawa , 10, Cello

 Andrew Winnicki   , 10, Violin

 Christopher Inouye, 10, Violin

>go north
Audition Room
You glance around the room seeing a woman sitting in the audiance section facing a stage. On the stage is a Grand Piano with a Paino Stool resting before it.

A beautiful sleek grand piano is centered in middle of the stage facing towards the audience section.

Hello, I'm Susan Wong I will be assessing your performance today. Just head up on the stage and begin when you are ready.

>x grand piano
You see nothing special about Grand Piano.

>x piano stool
A leather upholstered stool stands in front of the grand piano.

>go stage
You can't see any such thing.

>sit piano stool
I didn't understand that sentence.

>sit on the piano stool
You get into Piano Stool.

    *** As you play through your piece you realize that you have no idea what you are doing. Every note is completely off timed, you use no dynamics playing everything in a single monotone buzz. You glance over at Susan Wong and find that she has stood up. She exclaims, "This is so terrible I can't stand to here it for another second." Then storms out of the room. You have completely failed you audition. ***

In that game you scored 0 out of a possible 10, in 6 turns.

Would you like to RESTART, RESTORE a saved game, QUIT or UNDO the last command?

>restart
Today is the day! More than a decade of work has led you to this one moment. You nerviously walk down a paved stone hallway torwards your test. You are increadbly unprepared for this Piano Audition. You haven't practiced or even really decided on what piece you are going to play. In truth you grew so nevious everytime you thought of the audition that in the last few weeks leading up to now you had trained yourself not to think of it at all. You woke up today at 9:00 glad that it's finally the weekend and you can for go responsibilites for the next couple days only to find to your shock and dismay that on you calendar was writen Piano Audition: 10:00 A.M. You didn't have time to grab sheet music or anything else. You pass through from the west side of the hallway to the east stopping before the attendant's desk.

Prepare for Audition
An Interactive Fiction by Jonathan Nakagawa
Release 1 / Serial number 141007 / Inform 7 build 6L38 (I6/v6.33 lib 6/12N) SD

West Corridor
Beside you here the hum of a black vending machine. Behind you the hallway carries on the east. To the south is a bathroom. In front of you is a small reception desk with a clipboard resting on it and the attendant sitting behind it looking up at you expectantly.

Hello, you must be here for your piano audition. The reviewers are ready for you in the audition room the north. Lets get this over with quickly I really am starving.

>go east
East Corridor
You can hear your own foot falls as you walk down a stone walk way. An older man sits hunched over on a cushioned bench cleaning his finger nails. To the north is the Music Library where all sorts of sheet music is kept. To your south is a Practice Room. Both rooms are locked because its after hours.

* * *

>x older man
You see nothing special about Pianist.

>go east
You can't go that way.

>go west
West Corridor
Beside you here the hum of a black vending machine. Behind you the hallway carries on the east. To the south is a bathroom. In front of you is a small reception desk with a clipboard resting on it and the attendant sitting behind it looking up at you expectantly.

Hello, you must be here for your piano audition. The reviewers are ready for you in the audition room the north. Lets get this over with quickly I really am starving.

>x black vending machine
A large oblong metal box is pressed up against the wall humming softly. It is filled with various food products.

>i
You are carrying:
  Two Quarters
  Dollar

>x food products
The vending machine contains packets of oreos, peanuts, and apples.

>two quarter dollar into vending machine
That's not a verb I recognise.

>pay two quarter dollar
You can't use multiple objects with that verb.

>pay dollar
(to Attendant)
Attendant doesn't seem interested.

>pay dollar vending machine
You can only do that to something animate.

>buy peanuts
A package of Peanuts pops out of the machine with a satisfying cha-ching.

>i
You are carrying:
  Peanuts
  Two Quarters

>give peanuts
(to Attendant)
"Thank you so much! I'm sure the reviewers can wait a while. Here is the key to where we keep all our sheet music. Good luck"

>go east
East Corridor
You can hear your own foot falls as you walk down a stone walk way. An older man sits hunched over on a cushioned bench cleaning his finger nails. To the north is the Music Library where all sorts of sheet music is kept. To your south is a Practice Room. Both rooms are locked because its after hours.

>go north
(first unlocking the Music Library Door with The Library Key, then opening the door 

Music Library
Rows and rows of sheet music fill this room lining the walls and stretching from floor to celling. However, only shelf holds piano music. A plaque is afixed next to the door frame you just entered through.

You can see Shelf here.

>x shelf
Of the hundreds of pieces here you only recognize a few Ravel's Piano Concerto in g major, Beethoven's Fifth Piano Concerto in e-flat major, Prokofiev's second Piano Concerto, and Twinkle Twinkle Little Star.

>take Prokofiev's second Piano Concerto
Such a difficult piece will be sure to awe the reviewers if you can pull it off.

>i
You are carrying:
  Sheet Music of Prokofiev's second Piano Concerto
  Library Key
  Two Quarters

>go south
East Corridor
You can hear your own foot falls as you walk down a stone walk way. An older man sits hunched over on a cushioned bench cleaning his finger nails. To the north is the Music Library where all sorts of sheet music is kept. To your south is a Practice Room. Both rooms are locked because its after hours.

>go south
(first unlocking the Practice Room Door with The Music Room Key, then opening the door 

Practice Room
As you enter the Practice room only two pieces of furniture stand out to you. One is a black piano with a seat before it on one wall of the room and the other a small dresser. The hallway is back to the north.

>i
You are carrying:
  Sheet Music of Prokofiev's second Piano Concerto
  Library Key
  Two Quarters

>unlock door
What do you want to unlock Practice Room Door with?

>library
That's unlocked at the moment.

>key
That's not a verb I recognise.

>south
You can't go that way.

>i
You are carrying:
  Sheet Music of Prokofiev's second Piano Concerto
  Library Key
  Two Quarters

>s
You can't go that way.

>l
Practice Room
As you enter the Practice room only two pieces of furniture stand out to you. One is a black piano with a seat before it on one wall of the room and the other a small dresser. The hallway is back to the north.

>n
East Corridor
You can hear your own foot falls as you walk down a stone walk way. An older man sits hunched over on a cushioned bench cleaning his finger nails. To the north is the Music Library where all sorts of sheet music is kept. To your south is a Practice Room. Both rooms are locked because its after hours.

>n
Music Library
Rows and rows of sheet music fill this room lining the walls and stretching from floor to celling. However, only shelf holds piano music. A plaque is afixed next to the door frame you just entered through.

You can see Shelf (empty) here.

>s
East Corridor
You can hear your own foot falls as you walk down a stone walk way. An older man sits hunched over on a cushioned bench cleaning his finger nails. To the north is the Music Library where all sorts of sheet music is kept. To your south is a Practice Room. Both rooms are locked because its after hours.

>n
Music Library
Rows and rows of sheet music fill this room lining the walls and stretching from floor to celling. However, only shelf holds piano music. A plaque is afixed next to the door frame you just entered through.

You can see Shelf (empty) here.

>i
You are carrying:
  Sheet Music of Prokofiev's second Piano Concerto
  Library Key
  Two Quarters

* * *

>go south
East Corridor
You can hear your own foot falls as you walk down a stone walk way. An older man sits hunched over on a cushioned bench cleaning his finger nails. To the north is the Music Library where all sorts of sheet music is kept. To your south is a Practice Room. Both rooms are locked because its after hours.

>go south
Practice Room
As you enter the Practice room only two pieces of furniture stand out to you. One is a black piano with a seat before it on one wall of the room and the other a small dresser. The hallway is back to the north.

>practice Prokofiev's second Piano Concerto
I didn't understand that sentence.

>sit at piano
I didn't understand that sentence.

>x seat
A black leather seat rests before the piano.

>sit on seat
You get into Piano Seat.

You begin to practice working on all the most difficult sections of the piece. As you work away for more than half an hour you become noticeably better at the piece. You stand up turning to thank the man for his help only to find he is gone.

Practice Room
As you enter the Practice room only two pieces of furniture stand out to you. One is a black piano with a seat before it on one wall of the room and the other a small dresser. The hallway is back to the north.

[Your score has just gone up by six points.]

>sit on seat
You get into Piano Seat.

* * *

>l
Practice Room (in Piano Seat)
As you enter the Practice room only two pieces of furniture stand out to you. One is a black piano with a seat before it on one wall of the room and the other a small dresser. The hallway is back to the north.

>exit
You get out of Piano Seat.

Practice Room
As you enter the Practice room only two pieces of furniture stand out to you. One is a black piano with a seat before it on one wall of the room and the other a small dresser. The hallway is back to the north.

>go north
East Corridor
You can hear your own foot falls as you walk down a stone walk way. An older man sits hunched over on a cushioned bench cleaning his finger nails. To the north is the Music Library where all sorts of sheet music is kept. To your south is a Practice Room. Both rooms are locked because its after hours.

>go west
West Corridor
Beside you here the hum of a black vending machine. Behind you the hallway carries on the east. To the south is a bathroom. In front of you is a small reception desk with a clipboard resting on it and the attendant sitting behind it looking up at you expectantly.

Hello, you must be here for your piano audition. The reviewers are ready for you in the audition room the north. Lets get this over with quickly I really am starving.

>go north
Audition Room
You glance around the room seeing a woman sitting in the audiance section facing a stage. On the stage is a Grand Piano with a Paino Stool resting before it.

A beautiful sleek grand piano is centered in middle of the stage facing towards the audience section.

Hello, I'm Susan Wong I will be assessing your performance today. Just head up on the stage and begin when you are ready.

>x piano
(Sheet Music of Prokofiev's second Piano Concerto)
Prokofiev's second piano concerto is one of if not the hardest piano concerto ever written. It is nearly impossible to play it well.

>sit on piano stool
You get into Piano Stool.

    *** As you play through your piece you begin to frown. Every thing sounds okay. Nothing is particularly terrible but it isn't inspiring. Every note is just off timed, all the dynamics are relatively closely adhered to. You glance over at Susan Wong and find her slightly board gazing out a window. When you finish she says, "Not bad. Pay attention to some of the dynamics. Over all you did pretty well." Congratulations you passed your audition. ***

In that game you scored 6 out of a possible 10, in 45 turns.

Would you like to RESTART, RESTORE a saved game, QUIT or UNDO the last command?

* * *

>buy oreo
You can't see any such thing.

>buy oreos
A package of oreos pops out of the machine with a satisfying cha-ching.

* * *

>s
(first unlocking the Practice Room Door with The Music Room Key, then opening the door 

Practice Room
As you enter the Practice room only two pieces of furniture stand out to you. One is a black piano with a seat before it on one wall of the room and the other a small dresser. The hallway is back to the west.

>sit on seat
You get into Piano Seat.

You begin to practice working on all the most difficult sections of the piece. As you work away for more than half an hour you become noticeably better at the piece.

>n
You begin to practice working on all the most difficult sections of the piece. As you work away for more than half an hour you become noticeably better at the piece.

>up
You would have to get out of Piano Seat first.

You begin to practice working on all the most difficult sections of the piece. As you work away for more than half an hour you become noticeably better at the piece.

>exit
You get out of Piano Seat.

Practice Room
As you enter the Practice room only two pieces of furniture stand out to you. One is a black piano with a seat before it on one wall of the room and the other a small dresser. The hallway is back to the west.

* * *

>x west corridor
I only understood you as far as wanting to examine west.

>x command
You can't see any such thing.

>exit the west corridor
I only understood you as far as wanting to exit.

>exit east
I only understood you as far as wanting to exit.

>exit west corridor
I only understood you as far as wanting to exit.

>go east corridor
I only understood you as far as wanting to go east.

>go east
East Corridor
You can hear your own foot falls as you walk down a stone walk way. An older man sits hunched over on a cushioned bench cleaning his finger nails. To the north is the Music Library where all sorts of sheet music is kept. To your east is a Practice Room. Both rooms are locked because its after hours.

>go west
West Corridor
Beside you here the hum of a black vending machine. Behind you the hallway carries on the east. To the south is a bathroom. In front of you is a small reception desk with a clipboard resting on it and the attendant sitting behind it looking up at you expectantly.

Hello, you must be here for your piano audition. The reviewers are ready for you. Lets get this over with quickly I really am starving.

>ok
That's not a verb I recognise.

>enter room
You can't see any such thing.

>enter piano audition
You can't see any such thing.

>enter audition room
You can't see any such thing.

>go east
East Corridor
You can hear your own foot falls as you walk down a stone walk way. An older man sits hunched over on a cushioned bench cleaning his finger nails. To the north is the Music Library where all sorts of sheet music is kept. To your east is a Practice Room. Both rooms are locked because its after hours.

>enter Music Library
(first opening Music Library Door)
It seems to be locked.

>Enter practice room
(first opening Practice Room Door)
It seems to be locked.

>talk to older man
You can't see any such thing.

>x older man
You can't see any such thing.

>listen to older man
You can't see any such thing.

>man
That's not a verb I recognise.

>listen to man
You hear nothing unexpected.

>listen man
I only understood you as far as wanting to listen.

>talk to man
"Why does it have to be so damn hot all the time."

>i
You are carrying:
  Two Quarters
  Dollar

>go west corridor
I only understood you as far as wanting to go west.

>go west
West Corridor
Beside you here the hum of a black vending machine. Behind you the hallway carries on the east. To the south is a bathroom. In front of you is a small reception desk with a clipboard resting on it and the attendant sitting behind it looking up at you expectantly.

Hello, you must be here for your piano audition. The reviewers are ready for you. Lets get this over with quickly I really am starving.

>x vending machine
A large oblong metal box is pressed up against the wall humming softly. It is filled with various food products.

>take food products
That's hardly portable.

>x vending machine
A large oblong metal box is pressed up against the wall humming softly. It is filled with various food products.

>go south
You can't go that way.

>x food products
The vending machine contains packets of oreos, peanuts, and apples.

>take oreos
You need to buy them.

>purchase oreos
A package of oreos pops out of the machine with a satisfying cha-ching.

>i
You are carrying:
  Oreos
  Dollar

>talk attendant
I didn't understand that sentence.

>talk to attendant
"I am so incredibly hungry right now."

>give oreos
(to Attendant)
"Thank you so much! I'm sure the reviewers can wait a while. Here is the key to where we keep all our sheet music. Good luck"

>go east
East Corridor
You can hear your own foot falls as you walk down a stone walk way. An older man sits hunched over on a cushioned bench cleaning his finger nails. To the north is the Music Library where all sorts of sheet music is kept. To your east is a Practice Room. Both rooms are locked because its after hours.

>go north
(first unlocking the Music Library Door with The Library Key, then opening the door 

Music Library
Rows and rows of sheet music fill this room lining the walls and stretching from floor to celling. However, only shelf holds piano music.

You can see Shelf here.

>x shelf
Of the hundreds of pieces here you only recognize a few Ravel's Piano Concerto in g major, Beethoven's Fifth Piano Concerto in e-flat major, Prokofiev's second Piano Concerto, and Twinkle Twinkle Little Star.

>take Ravel's Piano Concerto in G Major
Taken.

>go west
You can't go that way.

>exit music library
I only understood you as far as wanting to exit.

>exit music
I only understood you as far as wanting to exit.

>exit library
I only understood you as far as wanting to exit.

>exit
But you aren't in anything at the moment.

>go south
East Corridor
You can hear your own foot falls as you walk down a stone walk way. An older man sits hunched over on a cushioned bench cleaning his finger nails. To the north is the Music Library where all sorts of sheet music is kept. To your east is a Practice Room. Both rooms are locked because its after hours.

>i
You are carrying:
  Sheet Music of Ravel's Piano Concerto in g major
  Library Key
  Dollar

>talk to man
What's that you have there. Oh Ravel yes that it a pretty little piece. I suppose I could help you clean up your technique if you want. Here's the key to the practice room. I'll meet you inside.

>go north
Music Library
Rows and rows of sheet music fill this room lining the walls and stretching from floor to celling. However, only shelf holds piano music.

You can see Shelf here.

>go south
East Corridor
You can hear your own foot falls as you walk down a stone walk way. An older man sits hunched over on a cushioned bench cleaning his finger nails. To the north is the Music Library where all sorts of sheet music is kept. To your east is a Practice Room. Both rooms are locked because its after hours.

>go west
West Corridor
Beside you here the hum of a black vending machine. Behind you the hallway carries on the east. To the south is a bathroom. In front of you is a small reception desk with a clipboard resting on it and the attendant sitting behind it looking up at you expectantly.

Hello, you must be here for your piano audition. The reviewers are ready for you. Lets get this over with quickly I really am starving.

>go northeast
You can't go that way.

>go east
East Corridor
You can hear your own foot falls as you walk down a stone walk way. An older man sits hunched over on a cushioned bench cleaning his finger nails. To the north is the Music Library where all sorts of sheet music is kept. To your east is a Practice Room. Both rooms are locked because its after hours.

>go east
You can't go that way.

>i
You are carrying:
  The Music Room Key
  Sheet Music of Ravel's Piano Concerto in g major
  Library Key
  Dollar

>go west
West Corridor
Beside you here the hum of a black vending machine. Behind you the hallway carries on the east. To the south is a bathroom. In front of you is a small reception desk with a clipboard resting on it and the attendant sitting behind it looking up at you expectantly.

Hello, you must be here for your piano audition. The reviewers are ready for you. Lets get this over with quickly I really am starving.

>go east
East Corridor
You can hear your own foot falls as you walk down a stone walk way. An older man sits hunched over on a cushioned bench cleaning his finger nails. To the north is the Music Library where all sorts of sheet music is kept. To your east is a Practice Room. Both rooms are locked because its after hours.

>go north
Music Library
Rows and rows of sheet music fill this room lining the walls and stretching from floor to celling. However, only shelf holds piano music.

You can see Shelf here.

* * *

>go south
East Corridor
You can hear your own foot falls as you walk down a stone walk way. An older man sits hunched over on a cushioned bench cleaning his finger nails. To the north is the Music Library where all sorts of sheet music is kept. To your east is a Practice Room. Both rooms are locked because its after hours.

>go south
(first unlocking the Practice Room Door with The Music Room Key, then opening the door 

Practice Room
As you enter the Practice room only two pieces of furniture stand out to you. One is a black piano with a seat before it on one wall of the room and the other a small dresser. The hallway is back to the west.

>x piano
(Sheet Music of Ravel's Piano Concerto in g major)
Ravel's piano concerto is on the easier side of piano concertos.

>practice
That's not a verb I recognise.

>play ravel's piano concerto in g major
That's not a verb I recognise.

>x dresser
A small wooden dresser stands in the corner of the room. A couple of loose pieces of paper rest on top of it along with several other random objects.

>take paper
You can't see any such thing.

>take random objects
That's hardly portable.

>x papers
You can't see any such thing.

>x paper
You can't see any such thing.

>x loose pieces of paper
You quickly scan the contents of the papers. They are flyers for an old recital performed here.

 "Piano Recital"

 Saturday, November 21st

 1:00 pm. -2:30 pm

 Ms. Susan Wong performing Liszt First Concerto

 Widely regarded as one of the most proficient performers of grand pieces critics rave.

 "Never before have I heard such musical complexity"

>x piano seat
A black leather seat rests before the piano.

>sit seat
I didn't understand that sentence.

>sit on seat
You get into Piano Seat.

>practice piano piece
That's not a verb I recognise.

>play piece
That's not a verb I recognise.

>play piano piece
That's not a verb I recognise.

* * *

>exit
You get out of Piano Seat.

Practice Room
As you enter the Practice room only two pieces of furniture stand out to you. One is a black piano with a seat before it on one wall of the room and the other a small dresser. The hallway is back to the west.

* * *

>exit
But you aren't in anything at the moment.

>go west
You can't go that way.

>go east
You can't go that way.

* * *

>go south
You can't go that way.

>go west
You can't go that way.

* * *

>l
Practice Room
As you enter the Practice room only two pieces of furniture stand out to you. One is a black piano with a seat before it on one wall of the room and the other a small dresser. The hallway is back to the west.

* * *

>x player
You can't see any such thing.

>x me
You glance down at yourself seeing that in your haste to get here you thew your clothes sloppily on yourself. One sock doesn't match the other and all the buttons on your shirt don't align perfectly.

* * *

>buy apples
An apple pops out of the machine with a satisfying cha-ching.

* * *

>eat apples
[Your score has just gone up by one point.]

>buy oreos
A package of oreos pops out of the machine with a satisfying cha-ching.

* * *

>n
(first unlocking the Music Library Door with The Library Key, then opening the door 

Music Library
Rows and rows of sheet music fill this room lining the walls and stretching from floor to celling. However, only shelf holds piano music.

You can see Shelf here.

>take prokofiev
Such a difficult piece will be sure to awe the reviewers if you can pull it off.

>s
East Corridor
You can hear your own foot falls as you walk down a stone walk way. An older man sits hunched over on a cushioned bench cleaning his finger nails. To the north is the Music Library where all sorts of sheet music is kept. To your east is a Practice Room. Both rooms are locked because its after hours.

>talk to man
What's that you have there. Prokofiev! There is no way you will be able to play that without my help. Here's the key to the practice room. I'll meet you inside.

>s
(first unlocking the Practice Room Door with The Music Room Key, then opening the door 

Practice Room
As you enter the Practice room only two pieces of furniture stand out to you. One is a black piano with a seat before it on one wall of the room and the other a small dresser. The hallway is back to the west.

>take flyer
Taken.

>sit on seat
You get into Piano Seat.

You begin to practice working on all the most difficult sections of the piece. As you work away for more than half an hour you become noticeably better at the piece. You stand up turning to thank the man for his help only to find he is gone.

Practice Room
As you enter the Practice room only two pieces of furniture stand out to you. One is a black piano with a seat before it on one wall of the room and the other a small dresser. The hallway is back to the west.

[Your score has just gone up by six points.]

>exit
But you aren't in anything at the moment.

>n
East Corridor
You can hear your own foot falls as you walk down a stone walk way. An older man sits hunched over on a cushioned bench cleaning his finger nails. To the north is the Music Library where all sorts of sheet music is kept. To your east is a Practice Room. Both rooms are locked because its after hours.

* * *

>n
Music Library
Rows and rows of sheet music fill this room lining the walls and stretching from floor to celling. However, only shelf holds piano music.

You can see Shelf (empty) here.

>read plaque
You quickly scan the contents of the plaque. It rambles on for awhile about the construction of the Music Building then discusses various musical techniques stating that "A common mistake of amateur pianists is the over dramatization of entire pieces. Many are so caught up in the pulse of the song that they fail to realize that certain sections are meant to be nondescript to act as a cleansing of the palate before the next dramatic section."

[Your score has just gone up by one point.]

>s
East Corridor
You can hear your own foot falls as you walk down a stone walk way. An older man sits hunched over on a cushioned bench cleaning his finger nails. To the north is the Music Library where all sorts of sheet music is kept. To your east is a Practice Room. Both rooms are locked because its after hours.

>w
West Corridor
Beside you here the hum of a black vending machine. Behind you the hallway carries on the east. To the south is a bathroom. In front of you is a small reception desk with a clipboard resting on it and the attendant sitting behind it looking up at you expectantly.

Hello, you must be here for your piano audition. The reviewers are ready for you in the audition room the north. Lets get this over with quickly I really am starving.

>n
Audition Room
You glance around the room seeing a woman sitting in the audiance section facing a stage. On the stage is a Grand Piano with a Paino Stool resting before it.

A beautiful sleek grand piano is centered in middle of the stage facing towards the audience section.

* * *

>talk to susan
"Wait, aren't you a Pianist?" you ask. "Yes, in fact I am. How did you know?" "I found this old flyer for one of your recitals." "Oh yes I remember this one. I think I will enjoy your playing very much."

[Your score has just gone up by two points.]

>sit on seat
You can't see any such thing.

>sit on stool
You get into Piano Stool.

    *** As you play through your piece you begin to frown. Every thing sounds okay. Nothing is particularly terrible but it isn't inspiring. Every note is just off timed, all the dynamics are relatively closely adhered to. You glance over at Susan Wong and find her slightly board gazing out a window. When you finish she says, "Not bad. Pay attention to some of the dynamics. Over all you did pretty well." Congratulations you passed your audition. ***

In that game you scored 10 out of a possible 11, in 21 turns.

Would you like to RESTART, RESTORE a saved game, QUIT or UNDO the last command?

* * *

>take oreo
You need to buy them.

>buy oreo
A package of oreos pops out of the machine with a satisfying cha-ching.

>give oreo
(to Attendant)
"Thank you so much! I'm sure the reviewers can wait a while. Here is the key to where we keep all our sheet music. Good luck"

>e
East Corridor
You can hear your own foot falls as you walk down a stone walk way. An older man sits hunched over on a cushioned bench cleaning his finger nails. To the north is the Music Library where all sorts of sheet music is kept. To your south is a Practice Room. Both rooms are locked because its after hours.

>n
(first unlocking the Music Library Door with The Library Key, then opening the door 

Music Library
Rows and rows of sheet music fill this room lining the walls and stretching from floor to celling. However, only shelf holds piano music. A plaque is afixed next to the door frame you just entered through.

You can see Shelf here.

* * *

>take twinkle
You are not sure what possessed you to take this piece over all the other great works surrounding you but you might as well make the best of it.

>s
East Corridor
You can hear your own foot falls as you walk down a stone walk way. An older man sits hunched over on a cushioned bench cleaning his finger nails. To the north is the Music Library where all sorts of sheet music is kept. To your south is a Practice Room. Both rooms are locked because its after hours.

>talk to man
What's that you have there. Twinkle Twinkle! Finally someone who understands that the greatest beauty comes from simplicity. Here's the key to the practice room. I'll meet you inside.

>s
(first unlocking the Practice Room Door with The Music Room Key, then opening the door 

Practice Room
As you enter the Practice room only two pieces of furniture stand out to you. One is a black piano with a seat before it on one wall of the room and the other a small dresser. The hallway is back to the north.

>x dresser
 A small wooden dresser stands in the corner of the room. A couple of loose pieces of paper rest on top of it along with several other random objects.

>x loose player
You can't see any such thing.

>x paper
You quickly scan the contents of the papers. They are flyers for an old recital performed here.

 "Piano Recital"

 Saturday, November 21st

 1:00 pm. -2:30 pm

 Ms. Susan Wong performing Liszt First Concerto

 Widely regarded as one of the most proficient performers of grand pieces critics rave.

 "Never before have I heard such musical complexity"

>take flyer
Taken.

* * *

>take oreos
You need to buy them.

>i
You are carrying:
  Two Quarters
  Dollar

>buy oreos
A package of oreos pops out of the machine with a satisfying cha-ching.

>i
You are carrying:
  Oreos
  Dollar

* * *

>practice concerto
You need to sit down first.

* * *

>e
East Corridor
You can hear your own foot falls as you walk down a stone walk way. An older man sits hunched over on a cushioned bench cleaning his finger nails. To the north is the Music Library where all sorts of sheet music is kept. To your east is a Practice Room. Both rooms are locked because its after hours.

>talk to older man
"Why does it have to be so damn hot all the time."

* * *

>n
Audition Room
You glance around the room seeing a woman sitting in the audiance section facing a stage. On the stage is a Grand Piano with a Paino Stool resting before it.

A beautiful sleek grand piano is centered in middle of the stage facing towards the audience section.

Hello, I'm Susan Wong I will be assessing your performance today. Just head up on the stage and begin when you are ready.

>play concerto
You need to sit down first.

* * *

>n
Audition Room
You glance around the room seeing a woman sitting in the audiance section facing a stage. On the stage is a Grand Piano with a Paino Stool resting before it.

A beautiful sleek grand piano is centered in middle of the stage facing towards the audience section.

Hello, I'm Susan Wong I will be assessing your performance today. Just head up on the stage and begin when you are ready.

>x woman
Susan Wong is a rather short black haired Asian woman. She is currently sitting in chair watching and waiting of you to head up to the stage.

* * *

>x vending machine
A large oblong metal box is pressed up against the wall humming softly. It is filled with various food products.

>E
East Corridor
You can hear your own foot falls as you walk down a stone walk way. An older man sits hunched over on a cushioned bench cleaning his finger nails. To the north is the Music Library where all sorts of sheet music is kept. To your south is a Practice Room. Both rooms are locked because its after hours.

>x older man
You see nothing special about Pianist.

* * *

I beg your pardon?

>E
You can't go that way.

>S
(first opening Practice Room Door)
It seems to be locked.

>l
East Corridor
You can hear your own foot falls as you walk down a stone walk way. An older man sits hunched over on a cushioned bench cleaning his finger nails. To the north is the Music Library where all sorts of sheet music is kept. To your south is a Practice Room. Both rooms are locked because its after hours.

>s
(first opening Practice Room Door)
It seems to be locked.

>e
You can't go that way.

* * *

I beg your pardon?

>w
West Corridor
Beside you here the hum of a black vending machine. Behind you the hallway carries on the east. To the south is a bathroom. In front of you is a small reception desk with a clipboard resting on it and the attendant sitting behind it looking up at you expectantly.

Hello, you must be here for your piano audition. The reviewers are ready for you in the audition room the north. Lets get this over with quickly I really am starving.

>l
West Corridor
Beside you here the hum of a black vending machine. Behind you the hallway carries on the east. To the south is a bathroom. In front of you is a small reception desk with a clipboard resting on it and the attendant sitting behind it looking up at you expectantly.

Hello, you must be here for your piano audition. The reviewers are ready for you in the audition room the north. Lets get this over with quickly I really am starving.

>x attendant
You see nothing special about Attendant.

>i
You are carrying:
  Two Quarters
  Dollar

>x vending machine
A large oblong metal box is pressed up against the wall humming softly. It is filled with various food products.

>use vending machine
That's not a verb I recognise.

>take two quarters
You already have that.

>use dollar
That's not a verb I recognise.

>x vending machine
A large oblong metal box is pressed up against the wall humming softly. It is filled with various food products.

>x food products
The vending machine contains packets of oreos, peanuts, and apples.

>x oreos
A few packets of oreos are held in the slot A1. The A1 button has  $0.50 written on it.

>x apples
A couple packaged apples are in slot A4. The A4 button reads $1.

>use dollar
That's not a verb I recognise.

>buy apple
You can't see any such thing.

>use $1
That's not a verb I recognise.

>too bad
That's not a verb I recognise.

>use A4
That's not a verb I recognise.

>use packaged apples
That's not a verb I recognise.

>i don't care
I only understood you as far as wanting to take inventory.

>i'm not hungry anymore
That's not a verb I recognise.

>use apples
That's not a verb I recognise.

>buy apples
An apple pops out of the machine with a satisfying cha-ching.

>i
You are carrying:
  Apples
  Two Quarters

>god dammit
That's not a verb I recognise.

>eat apples
[Your score has just gone up by one point.]

* * *

>buy oreos
A package of oreos pops out of the machine with a satisfying cha-ching.

>eat oreos
[Your score has just gone up by one point.]

>l
West Corridor
Beside you here the hum of a black vending machine. Behind you the hallway carries on the east. To the south is a bathroom. In front of you is a small reception desk with a clipboard resting on it and the attendant sitting behind it looking up at you expectantly.

Hello, you must be here for your piano audition. The reviewers are ready for you in the audition room the north. Lets get this over with quickly I really am starving.

>n
Audition Room
You glance around the room seeing a woman sitting in the audiance section facing a stage. On the stage is a Grand Piano with a Paino Stool resting before it.

A beautiful sleek grand piano is centered in middle of the stage facing towards the audience section.

Hello, I'm Susan Wong I will be assessing your performance today. Just head up on the stage and begin when you are ready.

>x Grand Piano
You see nothing special about Grand Piano.

>x Paino Stool
You can't see any such thing.

>x piano stool
A leather upholstered stool stands in front of the grand piano.

>x susan wong
Susan Wong is a rather short black haired Asian woman. She is currently sitting in chair watching and waiting of you to head up to the stage.

>play piano
That's not a verb I recognise.

>go to stage
You can't see any such thing.

>sit on piano stool
You get into Piano Stool.

    *** As you play through your piece you begin to glare. Every thing sounds slightly off. A few sections sound pretty terrible but some places sound nice. Every note is just off timed, all the dynamics are relatively closely adhered to. You glance over at Susan Wong and find her cleanning her finger nails. When you finish she says, "I won't lie that didn't sound like someone who was prepared. It could have been a lot worse but it could also have been a lot better." You have failed your audition ***

In that game you scored 2 out of a possible 10, in 32 turns.

Would you like to RESTART, RESTORE a saved game, QUIT or UNDO the last command?