Today is the day! More than a decade of work has led you to this one moment. You steadily trod into the music building suppressing the desire to bound forward wildly screaming from fear and excitement. You pass through the east side of a hallway stopping before the attendant's desk.

Prepare for Audition
An Interactive Fiction by Jonathan Nakagawa
Release 1 / Serial number 141003 / Inform 7 build 6L38 (I6/v6.33 lib 6/12N) SD

West Corridor
Beside you here the hum of a black vending machine. Behind you the hallway carries on the east. To the south is a bathroom. In front of you is a small reception desk with a clipboard resting on it and the attendant sitting behind it looking up at you expectantly.

Hello, you must be here for your piano audition. The reviewers are ready for you. Lets get this over with quickly I really am starving.

>u
You can't go that way.

* * *

>i
You are carrying:
  Two Quarters
  Dollar

* * *

>x food products
The vending machine contains packets of oreos, peanuts, and apples.

>x oreos
A few packets of oreos are held in the slot A1. The A1 button has  $0.50 writen on it.

* * *

>i
You are carrying:
  Oreo
  Dollar

* * *

>i
You are carrying:
  Two Quarters
  Dollar

>x machine
A large oblong metal box is pressed up against the wall humming softly. It is filled with various food products.

>x products
The vending machine contains packets of oreos, peanuts, and apples.

>buy oreos
A package of oreos pops out of the machine with a satisfying cha-ching.

>buy peanuts
A package of Peanuts pops out of the machine with a satisfying cha-ching.

* * *

>i
You are carrying:
  Two Quarters
  Dollar

>x food
The vending machine contains packets of oreos, peanuts, and apples.

>but apple
That's not a verb I recognise.

>buy apple
You can't see any such thing.

* * *

>buy apples
An apple pops out of the machine with a satisfying cha-ching.

>buy oreos
A package of oreos pops out of the machine with a satisfying cha-ching.

>talk to attendant
"I am so increably hungry right now."

>give attendant oreos
(first taking Oreos)
That's hardly portable.

>give attendant oreo
"Thank you so much! I'm sure the reviewers can wait a while. Here is the key to where we keep all our sheet music. Good luck"

>e
East Corridor
You can hear your own foot falls as you walk down a stone walk way. An older man sits hunched over on a cushioned bench cleaning his finger nails. To the north is the Music Library where all sorts of sheet music is kept. To your east is a Practice Room. Both rooms are locked because its after hours.

You can see Pianist here.

>n
You can't go that way.

>unlock door
Which do you mean, Music Library Door or Practice Room Door?

>music library door
What do you want to unlock Music Library Door with?

>library key
You unlock Music Library Door.

>n
You can't go that way.

>go north
You can't go that way.

* * *

>e
East Corridor
You can hear your own foot falls as you walk down a stone walk way. An older man sits hunched over on a cushioned bench cleaning his finger nails. To the north is the Music Library where all sorts of sheet music is kept. To your east is a Practice Room. Both rooms are locked because its after hours.

>talk to man
"Why does it have to be so damn hot all the time."

>talk to man
"Everybody is useless these days?"

>talk to man
"They just do not understand"

* * *

>e
East Corridor
You can hear your own foot falls as you walk down a stone walk way. An older man sits hunched over on a cushioned bench cleaning his finger nails. To the north is the Music Library where all sorts of sheet music is kept. To your east is a Practice Room. Both rooms are locked because its after hours.

>w
West Corridor
Beside you here the humm of a black vending machine. Behind you the the hallway carries on the east. To the south is a bathroom. Infront of you is a small reception desk with a clipboard resting on it and the attendant sitting behind it looking up at you expectantly.

>buy oreo
You can't see any such thing.

* * *

>buy oreos
A package of oreos pops out of the machine with a satisfying cha-ching.

>give oreo to attendant
"Thank you so much! I'm sure the reviewers can wait a while. Here is the key to where we keep all our sheet music. Good luck"

>e
East Corridor
You can hear your own foot falls as you walk down a stone walk way. An older man sits hunched over on a cushioned bench cleaning his finger nails. To the north is the Music Library where all sorts of sheet music is kept. To your east is a Practice Room. Both rooms are locked because its after hours.

You can see Pianist here.

>n
(first unlocking the Music Library Door with The Library Key, then opening the door 

Music Library
Rows and rows of sheet music fill this room lining the walls and streaching from floor to celling. However, only shelf holds piano music.

You can see Shelf (empty) here.

* * *

>e
East Corridor
You can hear your own foot falls as you walk down a stone walk way. An older man sits hunched over on a cushioned bench cleaning his finger nails. To the north is the Music Library where all sorts of sheet music is kept. To your east is a Practice Room. Both rooms are locked because its after hours.

>n
(first opening Music Library Door)
It seems to be locked.

>n
You can't go that way.

>e
You can't go that way.

>w
West Corridor
Beside you here the humm of a black vending machine. Behind you the the hallway carries on the east. To the south is a bathroom. Infront of you is a small reception desk with a clipboard resting on it and the attendant sitting behind it looking up at you expectantly.

>e
East Corridor
You can hear your own foot falls as you walk down a stone walk way. An older man sits hunched over on a cushioned bench cleaning his finger nails. To the north is the Music Library where all sorts of sheet music is kept. To your east is a Practice Room. Both rooms are locked because its after hours.

You can see Pianist here.

* * *

>n
(first opening Music Library Door)
It seems to be locked.

>w
West Corridor
Beside you here the humm of a black vending machine. Behind you the the hallway carries on the east. To the south is a bathroom. Infront of you is a small reception desk with a clipboard resting on it and the attendant sitting behind it looking up at you expectantly.

>buy oreos
A package of oreos pops out of the machine with a satisfying cha-ching.

* * *

>n
Audition Room
A beautiful sleek grand piano is centered in middle of the stage facing towards the audience section.

>sit on piano stool
You get into Piano Stool.

    *** As you play through your piece you begin to frown. Every thing sounds okay. Nothing is particularly terrible but it isn't inspiring. Every note is just off timed, all the dynamics are relatively closely adhered to. You glance over at Susan Wong and find her slightly board gazing out a window. When you finish she says, "Not bad. Pay attention to some of the dynamics." ***

In that game you scored 0 out of a possible 11, in 2 turns.

Would you like to RESTART, RESTORE a saved game, QUIT or UNDO the last command?

>x piano
(Grand Piano)
You see nothing special about Grand Piano.

* * *

>buy oreo
You can't see any such thing.

* * *

>buy oreos
A package of oreos pops out of the machine with a satisfying cha-ching.

>eat oreo
[Your score has just gone up by one point.]

>n
Audition Room
A beautiful sleek grand piano is centered in middle of the stage facing towards the audiance section.

>s
West Corridor
Beside you here the humm of a black vending machine. Behind you the the hallway carries on the east. To the south is a bathroom. Infront of you is a small reception desk with a clipboard resting on it and the attendant sitting behind it looking up at you expectantly.

Hello, you must be here for your piano audition. The reviewers are ready for you. Lets get this over with quickly I really am starving.

>s
Bathroom
Glancing around you see a few empty stalls, a row of sinks, and a doorway leading back the way you came to the north.

>x sinks
The sinks are old and flaked from years of use but they are still functional. Each sink has a rusted hot and cold water handle.

>n
West Corridor
Beside you here the humm of a black vending machine. Behind you the the hallway carries on the east. To the south is a bathroom. Infront of you is a small reception desk with a clipboard resting on it and the attendant sitting behind it looking up at you expectantly.

Hello, you must be here for your piano audition. The reviewers are ready for you. Lets get this over with quickly I really am starving.

>n
Audition Room
A beautiful sleek grand piano is centered in middle of the stage facing towards the audiance section.

>sit of piano stool
I didn't understand that sentence.

>sit on piano stoo;
You can't see any such thing.

>sit on piano stool
You get into Piano Stool.

    *** Player Wins ***

In that game you scored 1 out of a possible 11, in 9 turns.

Would you like to RESTART, RESTORE a saved game, QUIT or UNDO the last command?

* * *

>talk to attendant
"I am so increably hungry right now."

>talk to attendant
"Are you ready for your audition?"

>talk to attendant
"Good luck with your audition"

>talk to attendant
"Good luck with your audition"

* * *

>buy oreos
A package of oreos pops out of the machine with a satisfying cha-ching.

* * *

>give oreo to attendant
"Thank you so much! I'm sure the reviewers can wait a while. Here is the key to where we keep all our sheet music. Good luck"

>e
East Corridor
You can hear your own foot falls as you walk down a stone walk way. An older man sits hunched over on a cushioned bench cleaning his finger nails. To the north is the Music Library where all sorts of sheet music is kept. To your east is a Practice Room. Both rooms are locked because its after hours.

>n
(first unlocking the Music Library Door with The Library Key, then opening the door 

Music Library
Rows and rows of sheet music fill this room lining the walls and streaching from floor to celling. However, only shelf holds piano music.

You can see Shelf here.

* * *

>s
(first opening Practice Room Door)
It seems to be locked.

>i
You are carrying:
  Library Key
  Dollar

>unlock music library door
What do you want to unlock Music Library Door with?

>library key
That's unlocked at the moment.

* * *

>open door
Which do you mean, Music Library Door or Practice Room Door?

>music library
That's already open.

* * *

>n
(first unlocking the Music Library Door with The Library Key, then opening the door 

Music Library
Rows and rows of sheet music fill this room lining the walls and streaching from floor to celling. However, only shelf holds piano music.

You can see Shelf here.

>x shelf
Of the hundreds of pieces here you only reconize a few Ravel's Piano Concerto in g major, Beethoven's Fifth Piano Concerto in e-flat major, Prokofiev's second Piano Concerto, and Twinkle Twinkle Little Star.

>take Prokofiev's second Piano concerto
Such a difficult piece will be sure to awe the reviewers if you can pull it off.

>s
East Corridor
You can hear your own foot falls as you walk down a stone walk way. An older man sits hunched over on a cushioned bench cleaning his finger nails. To the north is the Music Library where all sorts of sheet music is kept. To your east is a Practice Room. Both rooms are locked because its after hours.

* * *

>talk to man
What's that you have there. Prokofiev! There is no way you will be able to play that without my help. Here's the key to the practice room. I'll meet you inside.

>s
(first unlocking the Practice Room Door with The Music Room Key, then opening the door 

Practice Room
As you enter the Practice room only two pieces of furnature stand out to you. One is a black piano with a seet before it on one wall of the room and the other a small dresser. The the hallway is back to the west.

>sit on seat
You get into Piano Seat.

* * *

>buy oreos
A package of oreos pops out of the machine with a satisfying cha-ching.

>give oreos to attendant
(first taking Oreos)
That's hardly portable.

>i
You are carrying:
  Oreo
  Dollar

>give oreo to attendant
"Thank you so much! I'm sure the reviewers can wait a while. Here is the key to where we keep all our sheet music. Good luck"

* * *

>e
East Corridor
You can hear your own foot falls as you walk down a stone walk way. An older man sits hunched over on a cushioned bench cleaning his finger nails. To the north is the Music Library where all sorts of sheet music is kept. To your east is a Practice Room. Both rooms are locked because its after hours.

>e
You can't go that way.

>n
(first unlocking the Music Library Door with The Library Key, then opening the door 

Music Library
Rows and rows of sheet music fill this room lining the walls and streaching from floor to celling. However, only shelf holds piano music.

You can see Shelf here.

* * *

>x shelf
Of the hundreds of pieces here you only reconize a few Ravel's Piano Concerto in g major, Beethoven's Fifth Piano Concerto in e-flat major, Prokofiev's second Piano Concerto, and Twinkle Twinkle Little Star.

>take favel
You can't see any such thing.

>take ravel
You can't see any such thing.

>take sheet music
Which do you mean, Sheet Music of Ravel's Piano Concerto in g major, Sheet Music of Beethoven's Fifth Piano Concerto in e-flat major, Sheet Music of Prokofiev's second Piano Concerto or Sheet Music of Twinkle Twinkle Little Star?

>ravel's
Taken.

>x shelf
Of the hundreds of pieces here you only reconize a few Ravel's Piano Concerto in g major, Beethoven's Fifth Piano Concerto in e-flat major, Prokofiev's second Piano Concerto, and Twinkle Twinkle Little Star.

>take sheet music of prokofiev's second piano concerto
Such a difficult piece will be sure to awe the reviewers if you can pull it off.

>i
You are carrying:
  Sheet Music of Prokofiev's second Piano Concerto
  Library Key
  Dollar

>s
East Corridor
You can hear your own foot falls as you walk down a stone walk way. An older man sits hunched over on a cushioned bench cleaning his finger nails. To the north is the Music Library where all sorts of sheet music is kept. To your east is a Practice Room. Both rooms are locked because its after hours.